|----------------------|							|---------------------------------------------|	
|......................|----------------------------..............................................|
|.................................................................................................|
|.................................................................................................|
|.....................|------------------------------|............................................|
|.....................|                              |............................................|
|.....................|                              |........../........................c........|
 ----------------------                              ---------------------------------------------