|-----------------------|							|---------------------------------------------|	
|......................|----------------------------..............................................|
|..................................................................................................|
|..................................................................................................|
|.....................|------------------------------|.............................................|
|.....................|                              |.............................................|
|.....................|                              |........../.........................c........|
 -----------------------                              ----------------------------------------------